----------------------------------
----------------------------------
----------------------------------
----------------------------------
----------------------------------
----------------------------------
----------------------!-----------
----------------------------------
----------------------------------
----------------------------------
----------------!---S@S!S---------
----------------------------------
----------------------------tt----
---M-----------------g------tt----
XXXXXXXXXXXXXXXXXXXXXXXXXXXXXXXXXX
XXXXXXXXXXXXXXXXXXXXXXXXXXXXXXXXXX